joaquin	x o a k i ng
hugo	u G o
fabio	f a b j o
miguel	m i g e l
gabriel	G a b rf j e l
sandra	s a n d rf a
sergio	s e rf x j o
lucas	l u k a s
maite	m aI t e
nuria	n u rf j a
coco	k o k o
pedro	p e D rf o
beso	b e s o
laura	l aU rf a
juana	x w a n a
andres	a n d rf e s
tania	t a n j a
judit	L u D i t
ingrid	i ng g rf i
ester	e s t e rf
raquel	r a k e l
julia	x u l j a
ivan	i b a n
ines	i n e s
belen	b e l e ng
george	L o rf L
simon	s i m o ng
v√≠ctor	b i+ k t o rf
a	a
ana	a n a
edgar	e D G a rf
de	d e
diego	d j e G o
tiro	t i rf o
pablo	p a b l o
emma	e m m a
omar	o m a rf
alba	a l b a
mario	m a rf j o
salma	s a l m a
toco	t o k o
silvia	s i l b j a
olga	o l G a
pateo	p a t e o
nadia	n a D j a
pilar	p i l a rf
empujo	e m p u x o
paula	p aU l a
borja	b o rf x a
eva	e b a
levanto	l e b a n t o
raul	r aU l
juncal	x u n k a l
